+---------+---------+
|         |         |
|         |         |
|                   |
|                   |
|         |          
|         |         |
+---  ----+----  -+ +
|         |       | |
|         |       | |
|                 | |
|                 | |
|         |   ----+ |
|         |         |
+---------+---------+
                     