+---------+---------+
|         |         |
|         |         |
|                   |
|                   |
|         |     |   |
|         |         |
+---  ----+----  ---+
|         |         |
|         |         |
|                   |
|                   |
|         |         |
|         |         |
+---------+---------+
                     