+-------------+---------+
|             |         |
| ------------|         |
|                       |
|                       |
|             | ------+ |
|             |       | |
+-------  ----+----   | |
|         |   |       | |
|         |   |       | |
|         |           | |
|         |           |  
|         |   |   ----+ |
|         |   |         |
|             |         |
+-------------+---------+
                     